┌────────────────────┐
┃....................│
┃................^...│
┃....................│
┃....................│
┃....................│
┃....................│
┃................$...│
┃....................│
┃....................│
┃....................│
┃....................│
┃....................│
┃....................│
┃....................│
┃....................│
┃....................│
┃....................│
┃....................│
┃....................│
┃....................│
└━━━━━━━━━━━━━━━━━━━━┘